11111111111
10000000001
10111111101
10100000101
10111111101
10000000009
10111111101
10100000101
10111111101
10000000001
11111111111